#domain
hospital
#levelname
MAsimple1
#colors
red: 0, 1
#initial
+++++++++++
+++++++++ +
+1+++++++ +
+         +
+0+++++++ +
+++     +++
#goal
+++++++++++
+++++++++0+
+ +++++++ +
+         +
+ +++++++1+
+++     +++
#end
