#domain
hospital
#levelname
group44
#colors
red: 0, 1, 6, O, M
blue: 2
pink: 3, B
green: 4
brown: 5, D
orange: 7, A, E, Y, N
#initial
++++++++++++++++
+ ++++ ++2  D ++
+      + ++ ++3+
+0++++1+ ++ ++ +
++++++++       +
++ +   + ++ ++ +
++ +++++5++ ++ +
+ E   6++B   4++
+      +++++++++
+  A           +
+ OMNYOMNYOMNY +
+     7        +
+ OMNYOMNYOMNY +
++++++++++++++++
#goal
++++++++++++++++
+1++++0++     ++
+      +4++ ++B+
+ ++++ + ++ ++ +
++++++++       +
++6+   + ++ ++ +
++ +++++D++ ++2+
+      ++     ++
+      +++++++++
+              +
+              +
+        A     +
+              +
++++++++++++++++
#end
