#domain
hospital
#levelname
MAsimple1
#colors
red: 0, A
green: 1, B
blue: 2, C
orange: 3, D
#initial
++++++++++++++++++++++++++++
+0   +          2     3   A+
+  A +       C          B  +
+++++ +++++++++++++ D+++++++
+ 1        B+              +
++++++++++++++++++++++++++++
#goal
++++++++++++++++++++++++++++
+A   +             D       +
+    +                     +
+++++ +++++++++++++  +++++++
+B          +C             +
++++++++++++++++++++++++++++
#end
