#domain
hospital
#levelname
MAsimple1
#colors
red: 0, A
green: 1, B
#initial
++++++++++++++++++++++++++++
+             0  B         +
+  A                A      +
++++++++++++++++++++++++++++
+ 1           B           A+
++++++++++++++++++++++++++++
#goal
++++++++++++++++++++++++++++
+   A                   A  +
+                          +
++++++++++++++++++++++++++++
+                       B  +
++++++++++++++++++++++++++++
#end
